15 15 15 15 14 15 15 15 15 15 15 44 15 15 15 15 15 15 15 15
93 15 15 15 14 15 15 15 15 15 15 15 15 15 15 15 15 15 15 15
60 15 15 15 45 15 15 15 15 15 15 15 15 15 15 15 15 15 15 15
15 15 15 15 55 15 15 15 15 15 15 15 15 15 15 15 15 15 15 15
15 15 15 15 65 15 15 15 15 15 15 15 15 15 15 15 15 15 15 15
04 04 04 04 04 04 15 15 15 15 15 15 15 15 15 15 15 15 15 15
66 67 68 69 15 15 15 15 04 15 15 15 15 15 15 15 15 15 15 15
76 77 78 79 15 15 15 15 15 15 04 04 15 15 15 15 15 15 15 15
86 87 88 89 15 10 15 04 04 15 15 15 15 15 15 15 15 96 15 15
04 04 04 04 04 20 15 15 15 15 15 15 15 15 15 15 15 60 15 15
15 15 15 15 15 30 15 15 15 15 15 15 15 15 15 15 15 15 15 15
15 15 15 15 15 40 15 15 15 15 15 15 15 15 15 15 15 15 15 15
15 15 04 04 04 04 04 04 15 15 15 15 15 15 15 15 04 04 04 04
15 15 15 15 15 15 15 15 04 15 15 15 15 15 15 15 15 15 15 15
15 15 15 15 15 15 15 15 15 15 15 04 15 15 15 15 15 15 15 15
15 15 15 15 14 15 15 15 15 15 04 15 15 15 15 15 15 15 15 15
15 15 15 15 14 11 10 15 04 15 15 15 15 15 15 15 15 15 15 15
15 15 15 15 14 04 20 15 15 15 15 15 15 15 15 15 15 15 15 15
15 15 15 15 15 15 30 15 15 15 15 15 15 15 15 15 15 15 15 15
19 15 15 15 15 15 40 15 15 15 15 15 15 80 15 15 15 15 15 15
09 09 09 09 09 09 09 09 09 09 09 09 09 09 09 09 09 09 09 09