15 15 15 15 15 15 15 15 15 0 1 2 15 15 15 15 15 15 15 15 15
15 0 1 2 15 15 15 15 15 6 7 8 15 15 15 15 15 15 15 15
15 6 7 8 15 15 15 15 15 15 15 15 15 15 15 15 15 15 15 15 15
15 15 15 15 15 15 15 15 15 15 15 15 15 0 1 2 15 15 15 15 15
15 15 15 15 15 15 15 0 1 2 15 15 15 6 7 8 15 15 15 15 15
15 15 15 15 15 15 15 6 7 8 15 15 15 15 15 15 15 15 15 15 15
1 2 15 15 15 15 15 15 15 15 15 15 15 15 15 15 15 15 15 15 15
7 8 15 15 15 15 15 15 15 15 15 15 15 15 15 15 15 15 15 15 15
15 15 15 15 15 15 15 15 15 15 15 15 15 15 15 15 15 15 15 15 15
15 15 15 15 15 15 15 15 15 15 15 15 15 15 15 15 15 15 15 15 15
15 15 15 15 15 10 11 5 9 9 10 15 15 15 15 15 15 15 15 15 15
15 15 15 15 15 15 11 15 15 15 15 15 15 15 15 15 15 15 15 15 15
15 15 15 15 15 15 11 15 15 15 15 15 15 15 15 15 15 15 15 15 15
3 3 3 3 3 3 3 15 15 15 15 15 15 15 15 15 15 15 15 15 15