15 15 15 15 15 15 15 15 15 15 15 15 15 15 15 15 06 07 08 15
15 11 15 15 01 01 00 15 15 15 15 15 15 15 15 15 16 17 18 15
04 04 04 15 00 02 01 15 15 15 15 15 15 15 15 15 26 27 28 15
15 15 15 15 04 04 04 15 15 15 15 15 15 15 15 15 36 37 38 15
15 15 15 15 15 15 15 15 04 15 15 15 01 02 00 15 46 47 48 15
15 15 15 15 15 00 15 15 15 15 04 15 00 03 02 15 56 57 58 59
15 15 15 15 01 01 00 15 15 15 15 15 04 04 04 15 15 15 15 15
15 15 15 15 00 02 01 15 04 04 04 15 15 15 15 15 15 15 15 15
15 15 15 15 04 04 04 15 15 15 15 15 15 15 15 15 15 15 15 15
15 15 04 15 15 15 15 15 15 15 15 15 15 15 15 15 15 05 15 15
04 13 15 15 15 32 15 15 15 15 15 15 15 15 15 15 83 84 85 15
04 04 04 04 04 42 04 15 15 04 04 04 04 04 04 04 04 04 04 04
15 15 15 15 15 52 15 15 15 14 15 15 15 15 15 15 15 15 15 15
66 67 68 69 15 62 15 15 15 14 15 15 15 15 15 15 15 15 00 00
76 77 78 79 15 72 15 15 15 14 15 12 15 15 15 15 15 15 00 00
86 87 88 89 15 82 15 10 15 14 04 04 04 04 15 15 15 10 00 03
04 04 04 04 04 04 04 20 15 14 15 15 15 15 15 15 04 20 04 04
15 15 15 15 15 15 15 30 15 45 15 15 15 15 15 15 15 30 15 15
15 15 01 01 00 15 15 40 15 55 01 01 00 01 01 00 15 40 15 15
19 15 00 02 01 15 15 50 15 65 00 02 01 00 02 01 15 50 15 15
09 09 09 09 09 09 09 09 09 09 09 09 09 09 09 09 09 09 09 09