15 15 15 15 15 15 15 15 15 15 15 15 15 15 15 15 15 19 20 21
15 24 15 15 15 15 15 15 15 15 15 15 15 15 15 15 15 19 20 21
03 03 03 15 15 15 15 15 15 15 15 15 15 15 15 15 15 19 20 21
15 15 15 15 03 03 03 15 15 15 15 15 15 15 15 15 15 19 20 21
15 15 15 15 15 15 15 15 03 15 15 15 15 15 15 15 15 16 17 18
15 15 15 15 15 15 15 15 15 15 03 15 15 15 15 15 15 15 15 15
15 15 15 15 15 15 15 15 15 15 15 15 03 03 03 15 15 15 15 15
15 15 15 15 15 15 15 15 03 03 03 15 15 15 15 15 15 15 15 15
15 15 15 15 03 03 03 15 15 15 15 15 15 15 15 15 15 15 15 15
15 15 03 15 15 15 15 15 15 15 15 15 15 15 15 15 15 15 22 15
03 26 15 15 15 15 15 15 15 15 15 15 15 15 15 15 15 15 15 15
03 03 03 03 03 11 03 15 15 03 03 03 03 03 03 03 03 03 03 03
15 15 15 15 15 11 15 15 15 03 15 15 15 15 15 15 15 15 15 15
15 15 15 15 15 11 15 15 15 03 15 15 15 15 15 15 15 15 15 15
15 15 15 15 15 11 15 15 15 03 15 25 15 15 15 15 15 15 15 15
15 15 15 15 15 11 15 15 15 03 03 03 03 03 15 15 15 15 15 15
03 03 03 03 03 03 03 11 15 03 15 15 15 15 15 15 03 11 03 03
15 15 15 15 15 15 15 11 15 15 15 15 15 15 15 15 15 11 15 15
15 15 13 13 13 15 15 11 15 15 13 13 13 13 13 13 15 11 15 15
14 15 13 12 13 15 15 11 15 15 13 12 13 13 12 13 15 11 15 15
03 03 03 03 03 03 03 03 03 03 03 03 03 03 03 03 03 03 03 03
