14 14 14 14 15 15 15 45 15 15 14 13 00 00 15 15 15 15 15 15
06 07 08 14 15 15 15 55 15 15 14 02 00 00 15 15 15 15 15 15
16 17 18 14 12 15 15 65 10 15 14 02 02 00 15 15 15 15 15 15
26 27 28 14 14 14 14 14 20 15 14 14 14 14 14 14 14 15 15 15
36 37 38 14 15 15 15 15 30 15 15 15 15 15 15 15 14 15 15 15
46 47 48 14 15 10 15 15 40 15 15 15 10 15 15 15 14 15 15 15
56 57 58 14 23 24 14 14 14 15 15 14 20 14 14 14 14 15 15 15
15 15 15 14 15 30 14 15 15 15 15 15 30 15 15 15 15 15 15 15
15 15 15 14 15 40 14 15 15 15 15 15 40 15 15 15 15 15 15 15
15 15 15 14 15 30 14 15 15 15 15 14 14 14 14 14 14 15 15 15
15 15 15 14 15 40 14 15 15 15 15 14 15 15 00 00 14 15 15 15
15 05 15 14 15 30 14 15 15 15 15 15 00 15 02 02 14 15 15 15
83 84 85 14 15 40 14 15 15 15 15 15 00 21 00 02 14 15 15 15
14 14 14 14 15 30 23 24 24 25 15 14 14 14 14 14 14 15 15 15
00 00 15 15 15 40 15 15 15 15 15 15 66 67 68 69 14 15 15 15
02 00 00 15 15 30 15 15 15 15 15 15 76 77 78 79 14 15 15 15
02 02 00 15 11 40 15 15 15 15 15 15 86 87 88 89 14 15 15 15
14 14 14 14 14 14 15 15 15 15 15 14 14 14 14 14 14 15 15 15
15 15 15 15 15 15 15 15 15 15 15 15 15 15 15 15 15 15 15 15
19 15 15 15 15 15 15 15 15 15 15 15 15 15 15 15 15 80 15 15
09 09 09 09 09 09 09 09 09 09 09 09 09 09 09 09 09 09 09 09