15 15 15 15 15 15 15 15 15 15 15 15 15 15 15 15 14 15 15 15
15 15 15 15 15 15 15 15 15 15 15 15 15 15 15 15 15 15 15 15
15 15 15 15 15 15 15 15 15 15 15 15 15 15 15 15 15 15 15 15
15 15 15 15 15 15 15 15 15 15 15 15 15 15 15 14 14 15 15 15
15 15 15 15 15 15 15 15 15 15 15 15 15 15 15 15 14 15 15 15
15 15 15 15 15 15 15 15 15 15 15 15 15 15 15 15 14 15 15 15
15 15 15 15 15 15 15 15 15 15 15 15 15 15 15 15 15 15 15 15
15 15 15 15 15 15 15 15 15 15 15 15 15 15 15 15 15 15 15 15
15 15 15 15 15 15 15 15 15 15 15 15 15 15 14 14 14 15 15 15
15 15 15 15 15 15 15 15 15 15 15 15 15 15 14 15 15 15 15 15
15 15 15 15 15 15 15 15 15 15 15 15 15 15 14 15 15 15 15 15
15 15 15 15 15 15 15 15 15 15 15 15 15 15 14 15 15 15 15 15
15 15 15 15 15 15 15 15 15 15 15 15 15 15 14 15 15 15 15 15
15 15 15 15 15 15 15 15 15 15 15 15 15 15 14 15 15 15 15 15
15 15 15 15 15 15 15 15 15 15 15 15 15 15 14 15 15 15 15 15
15 15 15 15 15 15 15 15 15 15 15 15 15 15 14 15 15 15 15 15
15 15 15 15 15 15 15 15 15 15 15 15 15 15 14 15 15 15 15 15
15 15 15 15 15 15 15 15 15 15 15 15 15 15 14 15 15 15 15 15
15 15 15 15 15 15 05 15 15 15 15 15 15 15 14 15 15 15 15 15
19 15 15 15 15 83 84 85 15 15 15 15 15 15 15 15 15 80 15 15
09 09 09 09 09 09 09 09 09 09 09 09 09 09 09 09 09 09 09 09